button1,door2,,,,,,,,
button2,door4,,,,,,,,
button3,door3,,,,,,,,
button4,door1,,,,,,,,,
button5,,,,,,,,,,
|w,w,w,w,w,w,w,w,w,w,w,w,w
w,f,f,w,f,w,w,f,w,f,f,f,w
w,f,f,w,f,w,w,f,w,f,f,f,w
w,f,f,w,w,w,w,w,w,f,f,f,w
w,f,f,f,f,f,w,f,f,f,f,f,w
w,f,f,f,f,f,w,f,f,f,f,f,w
w,f,f,f,f,f,w,f,f,f,f,f,w
w,f,f,f,w,w,w,w,w,f,f,f,w
w,f,f,f,w,f,w,f,w,f,f,f,w
w,f,f,f,w,f,w,f,w,f,f,f,w
w,w,w,w,w,w,w,w,w,w,w,w,w