button1,door2,,,,,,,,,,,,
button2,door1,,,,,,,,,,,,
button3,,,,,,,,,,,,,
|w,w,w,w,w,w,w,w,w,w,w,w,w,w,w
w,f,f,f,f,f,f,w,f,f,f,f,f,f,w
w,f,f,f,f,f,f,w,f,f,f,f,f,f,w
w,f,f,f,f,f,f,w,f,f,f,f,f,f,w
w,f,w,w,w,w,w,w,w,w,w,w,w,f,w
w,f,w,f,f,f,w,f,w,f,f,f,w,f,w
w,f,w,f,w,f,w,f,w,f,w,f,w,f,w
w,f,w,f,w,f,w,f,w,f,w,f,w,f,w
w,f,w,f,w,f,w,f,w,f,w,f,w,f,w
w,f,w,f,w,f,w,f,w,f,w,f,w,f,w
w,f,f,f,w,f,f,f,f,f,w,f,f,f,w
w,w,w,w,w,w,w,w,w,w,w,w,w,w,w